16,6
464,96
0
31,12,12,31,31,12,22,13,12,12,18,34,34,34,34,0
22,12,22,27,13,22,23,14,13,12,12,18,34,34,34,0
27,22,27,27,23,8,34,34,25,13,12,31,18,34,34,0
25,27,23,8,34,34,34,34,34,14,25,22,13,6,6,6
7,14,34,34,34,1,7,34,34,34,34,14,27,13,12,12
27,7,1,7,1,27,27,7,1,1,7,7,14,25,13,12
doors
1,2,320,-40,352,32
end_doors
miscellaneous
end_miscellaneous
stair
2,408,64
end_stair
water
end_water
enemies
end_enemies
