24,6
64,64
41,27,36,27,36,27,36,41,20,27,38,41,39,27,38,41,28,43,34,34,46,40,43,0
41,27,5,27,5,27,5,41,20,41,36,41,36,41,36,41,28,2,34,34,4,3,2,0
41,27,5,27,5,27,5,41,20,41,5,41,5,41,5,41,22,8,34,37,10,9,32,0
41,27,5,27,5,27,5,41,27,41,5,41,5,41,5,41,27,34,29,26,34,30,31,0
41,27,27,11,42,19,27,41,27,41,5,41,5,41,6,6,6,18,34,34,34,16,22,0
28,28,28,28,28,28,28,28,6,6,6,6,6,6,6,23,25,22,18,34,34,25,33,0
doors
end_doors
breakable
1,2,2,1,1
1,2,2,1,1
1,2,2,1,1
1,2,2,1,1
1,2,2,1,1
1,2,2,1,1
1,2,2,1,1
1,2,2,1,11
end_breakable
stair
end_stair
enemies
end_enemies
