16,6
464,160
0
1,44,6,3,9,44,3,3,44,44,44,3,9,7,0,14
1,6,21,9,43,43,39,39,39,39,39,39,7,20,21,14
14,26,2,27,27,27,27,15,26,26,26,30,26,26,26,14
14,6,6,13,43,43,44,1,3,3,21,3,9,6,6,6
14,42,44,44,13,3,3,1,9,3,9,6,3,24,9,9
14,14,14,14,14,14,14,14,14,14,14,14,14,14,14,14
doors
5,2,432,-40,416,32
end_doors
miscellaneous
end_miscellaneous
stair
2,152,128
3,56,32
1,376,32
end_stair
enemies
end_enemies
