8,6
48,160
0
1,43,7,44,3,43,44,1
1,7,9,3,44,44,3,1
14,30,15,13,9,3,39,1
30,21,1,3,30,8,30,1
44,44,1,9,7,44,3,1
14,14,14,14,14,14,14,14
doors
end_doors
miscellaneous
end_miscellaneous
stair
end_stair
enemies
end_enemies
