16,6
48,160
0
1,30,2,26,30,30,30,30,19,25,42,19,25,0,6,1
1,36,0,13,6,36,42,24,31,37,36,31,37,6,0,1
30,30,30,30,30,30,30,30,30,30,30,30,30,13,36,1
0,6,0,19,25,6,42,0,42,19,25,6,6,8,30,30
6,43,42,31,37,36,36,6,24,31,37,0,7,6,36,24
14,14,14,14,14,14,14,14,14,14,14,14,14,14,14,14
doors
end_doors
miscellaneous
end_miscellaneous
stair
end_stair
enemies
end_enemies
