16,6
48,160
0
1,30,2,26,30,30,30,30,19,25,42,19,25,0,6,1
1,36,0,13,6,36,42,24,31,37,36,31,37,6,0,1
30,30,30,30,30,30,30,30,30,30,30,30,30,0,36,1
0,6,0,19,25,6,42,0,42,19,25,6,6,8,30,30
6,43,42,31,37,36,36,6,24,31,37,0,7,6,36,24
14,14,14,14,14,14,14,14,14,14,14,14,14,14,14,14
doors
1,2,64,-40,96,31
end_doors
miscellaneous
1,30,96,1,1
1,91,32,1,1
1,155,128,1,1
1,219,32,1,14
1,283,96,1,1
1,347,96,1,15
1,411,32,1,1
1,475,32,1,1
end_miscellaneous
stair
1,376,128
4,440,64
2,120,32
end_stair
enemies
7,80,160
end_enemies
