32,6
976,160
1
1,17,16,29,23,16,23,17,16,23,23,47,46,23,17,16,23,23,17,16,17,23,17,16,23,23,17,16,17,23,17,16
1,23,16,40,40,16,40,23,16,29,35,11,5,35,23,16,29,35,23,16,23,35,23,16,29,40,23,16,23,40,23,16
1,29,16,40,40,16,35,40,16,47,46,35,35,47,46,16,40,47,46,16,29,47,46,16,40,47,46,16,29,40,40,16
32,35,16,40,40,16,41,27,16,11,5,41,41,11,5,16,35,11,5,16,35,11,5,16,35,11,5,16,40,40,40,16
38,41,26,26,26,26,41,1,16,35,35,41,41,35,35,16,41,35,35,16,41,35,35,16,41,35,35,16,35,35,35,16
14,14,14,14,14,14,14,14,14,14,14,14,14,14,14,14,14,14,14,14,14,14,14,14,14,14,14,14,14,8,14,14
doors
5,2,912,194,928,192
end_doors
miscellaneous
end_miscellaneous
stair
4,952,128
end_stair
enemies
103,210.f,0.f
end_enemies
