40,6
48,160
0
1,19,25,42,0,6,42,6,0,0,0,6,42,14,1,0,1,0,0,0,0,0,6,0,1,0,0,6,6,0,0,1,0,0,43,6,43,0,1,14
1,31,37,36,0,42,24,12,24,24,6,6,24,14,1,6,1,6,0,6,6,6,0,0,1,6,6,6,6,0,6,1,6,6,30,30,30,30,1,14
30,30,30,30,2,30,30,30,30,30,14,2,30,50,1,0,1,6,19,43,43,25,0,6,1,0,19,43,43,25,0,1,24,6,12,12,42,6,1,14
42,0,6,0,0,13,0,0,0,0,14,0,13,0,1,0,1,42,31,43,43,43,6,42,1,42,31,43,43,37,6,1,30,42,18,18,24,42,1,32
24,36,0,30,36,30,30,6,0,36,14,6,6,14,14,6,1,36,31,43,43,43,12,24,1,36,31,43,43,37,24,1,24,20,49,14,14,20,1,38
14,14,2,14,14,14,14,14,14,14,14,14,14,14,14,14,14,14,14,14,14,14,14,14,14,14,14,14,14,14,14,14,14,14,14,14,14,14,14,14
doors
end_doors
miscellaneous
end_miscellaneous
stair
end_stair
enemies
end_enemies
