40,6
260,160
0
14,44,44,9,3,44,3,44,44,44,3,9,3,44,3,34,9,1,34,34,34,1,34,34,14,44,21,44,21,3,44,9,44,3,21,9,21,44,21,1
14,3,3,44,9,3,44,3,39,39,39,9,27,27,27,27,3,1,28,28,28,1,28,28,14,24,39,3,39,39,9,3,39,39,39,33,33,33,39,1
14,27,2,27,27,27,27,27,14,27,27,13,4,10,10,4,12,1,22,22,22,1,22,30,15,30,30,2,27,27,27,27,14,15,27,27,27,27,8,15
32,44,44,13,44,44,44,44,14,43,43,44,13,4,4,4,18,15,40,40,40,15,13,9,1,40,40,40,13,40,4,4,14,1,21,44,9,7,44,1
38,44,44,44,13,44,44,44,14,43,43,20,3,30,6,21,20,1,45,45,45,1,43,13,1,45,45,45,44,14,10,10,14,1,44,3,7,43,43,1
14,14,14,14,14,14,14,14,14,14,14,14,14,14,14,14,14,14,14,14,14,14,14,14,14,14,14,14,14,14,14,14,14,14,8,14,14,14,14,14
doors
3,2,1072,194,1088,192
4,1,0,96
end_doors
miscellaneous
end_miscellaneous
stair
4,1112,128
1,1144,128
4,1240,32
2,920,96
3,856,32
2,760,128
3,696,64
2,408,96
3,344,32
2,152,128
3,56,32
end_stair
enemies
end_enemies
