8,6
48,64
0
1,43,7,44,3,43,44,1
1,7,9,3,44,44,3,1
14,26,15,13,9,3,39,1
26,21,1,3,26,8,26,1
44,44,1,9,7,44,3,1
14,14,14,14,14,14,14,14
doors
end_doors
breakable
end_breakable
stair
end_stair
enemies
end_enemies
