24,6
48,64
0,10,12,10,30,10,12,10,22,30,30,2,30,10,12,10,30,10,30,10,30,10,12,0
0,10,30,10,12,10,30,10,2,30,30,30,12,10,2,10,30,10,30,31,12,10,22,0
39,10,21,31,21,31,21,31,30,30,12,21,30,10,22,31,21,31,12,10,21,31,17,0
1,31,2,14,13,14,13,14,30,30,30,14,22,14,13,14,13,10,17,14,13,14,13,0
0,14,12,10,30,10,30,31,17,12,21,31,23,31,17,31,21,31,21,31,21,31,21,0
0,10,11,26,2,26,13,14,13,28,13,14,28,7,13,14,13,14,13,14,13,14,13,0
doors
end_doors
miscellaneous
end_miscellaneous
stair
end_stair
enemies
end_enemies
