16,6
64,64
0
5,12,2,10,30,2,12,30,10,30,12,10,30,30,12,0
39,2,30,10,22,12,30,30,10,12,30,10,22,12,30,0
1,30,12,31,17,30,21,21,31,2,30,31,17,21,30,0
5,30,17,10,0,30,30,0,5,21,22,0,2,22,6,0
5,12,2,10,0,30,12,0,5,30,17,0,30,11,10,0
5,22,30,10,0,30,30,0,5,30,30,30,11,30,10,0
doors
end_doors
miscellaneous
end_miscellaneous
stair
end_stair
enemies
end_enemies
