8,6
48,160
0
5,10,30,30,11,22,10,0
5,10,30,11,30,2,10,0
0,31,37,17,21,30,10,0
0,10,2,30,30,6,31,0
39,10,30,30,11,30,22,0
1,31,17,37,21,21,17,0
doors
end_doors
miscellaneous
end_miscellaneous
stair
end_stair
enemies
end_enemies
