24,6
100,160.15
17,68,68,68,68,68,17,17,17,68,68,68,68,68,17,17,17,17,17,17,38,9,9,69
29,29,29,29,29,29,68,68,17,29,29,29,29,29,68,68,68,68,68,68,48,77,77,59
29,57,29,29,29,29,29,29,29,57,29,29,29,29,29,29,29,29,57,57,58,19,77,69
57,8,57,57,57,57,57,57,57,8,57,57,57,57,57,57,57,57,8,63,58,69,77,59
27,18,47,27,27,47,27,47,27,18,47,27,27,47,27,47,47,67,18,28,78,39,49,59
37,37,37,37,37,37,37,37,37,37,37,37,37,37,37,37,37,37,37,37,37,37,37,37
doors
1,0,672,64
end_doors
breakable
0,95,129
0,217,129
0,351,129
0,479,129
0,607,129
end_breakable