24,6
48,80
0,0,1,10,0,1,20,0,1,40,12,33,0,43,1,33,0,43,1,33,0,41,20,42
0,10,11,0,0,11,30,0,11,50,10,0,1,43,11,33,1,43,11,33,1,40,30,42
21,70,70,23,32,11,30,0,11,60,0,0,11,0,11,0,11,0,11,20,11,60,30,52
40,0,1,12,22,70,21,70,70,23,32,0,11,0,11,0,11,0,11,10,11,51,2,62
60,0,11,0,20,11,10,11,10,12,71,32,11,0,11,0,11,0,11,0,11,82,3,42
21,21,31,21,21,31,21,31,21,21,21,22,31,21,31,21,31,21,31,21,31,21,21,72
doors
end_doors
breakable
1,32,112,1,1
1,91,48,1,1
1,155,70,1,1
1,219,48,1,1
1,283,144,1,1
1,347,112,1,1
1,411,144,1,1
1,475,144,1,1
1,539,112,1,1
1,603,144,1,5
1,667,112,1,1

2,688,144,1,8

1,731,117,1,1
end_breakable
stair
1,680,112
end_stair
enemies
0,203.f,176.f,50.0,50.0
end_enemies