48,6
48,176
0,0
0,1,40,0,0,1,40,0,0,1,41,0,0,1,40,0,20,1,40,20,0,0,0,0,1,40,30,1,10,0,0,20,1,20,1,20,1,20,1,0,20,0,10,10,0,30,1,42
10,11,50,20,0,11,50,20,0,11,40,20,0,11,50,20,10,11,50,30,0,0,0,0,11,60,30,11,0,0,0,10,11,30,11,30,11,30,11,0,30,0,0,0,0,30,11,52
0,11,60,30,0,11,50,30,0,11,50,30,0,11,50,30,0,11,50,30,0,0,51,2,31,21,70,70,23,32,0,0,11,30,11,30,11,30,11,20,30,0,51,2,70,21,31,62
0,11,0,30,0,11,60,30,20,11,50,30,0,11,60,30,0,11,50,30,51,2,13,3,11,0,10,11,12,22,21,80,11,30,11,30,11,30,11,10,30,51,61,3,0,0,1,42
0,11,0,30,20,11,0,30,10,11,60,30,0,11,0,30,10,11,60,51,61,3,20,0,11,0,0,11,0,11,20,20,11,30,11,30,11,30,11,20,51,61,3,20,0,0,11,42
21,31,21,21,21,31,21,21,21,31,21,21,21,31,21,21,21,31,21,13,21,21,21,21,31,21,21,31,21,31,21,21,31,21,31,21,31,21,31,21,13,21,21,21,21,21,31,72
doors
2,1,1504,32
end_doors
miscellaneous
1,32,144,1,3
1,91,112,1,10
1,155,144,1,10
1,219,112,1,10
1,283,144,1,10
1,347,112,1,10
1,411,144,1,10
1,475,112,1,10
1,539,144,1,10
1,603,112,1,10
1,667,48,1,10
1,731,144,1,10
1,795,20,1,10
1,859,52,1,10
1,923,144,1,10
1,987,48,1,10

6,1008,112,1,3

1,1051,144,1,10
1,1115,144,1,10
1,1179,144,1,10
1,1243,144,1,10
1,1307,144,1,10
1,1371,107,1,10
1,1435,48,1,10
1,1499,20,1,10
end_miscellaneous
stair
end_stair
enemies
0,200.0,176.0,50.0,50.0
1,696.0,112.0
1,888.0,80.0
1,950.0,112.0
0,1300.0,176.0,50.0,50.0
end_enemies