48,6
100,176
0,1,40,0,0,1,40,0,0,1,41,0,0,1,40,0,20,1,40,20,0,0,0,0,1,40,30,1,10,0,0,20,1,20,1,20,1,20,1,0,20,0,10,10,0,30,1,42
10,11,50,20,0,11,50,20,0,11,40,20,0,11,50,20,10,11,50,30,0,0,0,0,11,60,30,11,0,0,0,10,11,30,11,30,11,30,11,0,30,0,0,0,0,30,11,52
0,11,60,30,0,11,50,30,0,11,50,30,0,11,50,30,0,11,50,30,0,0,51,2,31,21,70,70,23,32,0,0,11,30,11,30,11,30,11,20,30,0,51,2,70,21,31,62
0,11,0,30,0,11,60,30,20,11,50,30,0,11,60,30,0,11,50,30,51,2,13,3,11,0,10,11,12,22,21,70,11,30,11,30,11,30,11,10,30,51,61,3,0,0,1,42
0,11,0,30,20,11,0,30,10,11,60,30,0,11,0,30,10,11,60,51,61,3,20,0,11,0,0,11,0,11,20,20,11,30,11,30,11,30,11,20,51,61,3,20,0,0,11,42
21,31,21,21,21,31,21,21,21,31,21,21,21,31,21,21,21,31,21,13,21,21,21,21,31,21,21,31,21,31,21,21,31,21,31,21,31,21,31,21,13,21,21,21,21,21,31,72
doors
2,1,1504,32
end_doors
breakable
end_breakable
enemies
0,200.0,176.0,50.0,50.0
1,696.0,112.0
1,888.0,80.0
1,950.0,112.0
0,1300.0,176.0,50.0,50.0
end_enemies