24,6
48,64
0
0,0,0,17,37,12,39,39,39,0,0,0,0,0,0,0,0,0,0,0,17,12,37,16
0,0,0,17,12,37,39,39,12,7,0,0,0,0,0,0,0,0,0,0,17,37,39,45
0,0,0,42,37,39,39,12,37,6,14,0,0,27,20,0,0,0,0,0,42,39,39,4
0,0,0,7,39,37,39,37,39,6,6,11,0,43,46,11,0,0,7,14,7,10,30,16
30,30,22,30,30,30,30,30,30,30,30,36,20,36,36,30,20,30,36,30,30,37,12,16
24,37,37,22,37,30,12,12,12,18,24,18,1,42,1,42,1,42,12,37,12,39,37,16
doors
end_doors
miscellaneous
end_miscellaneous
stair
end_stair
enemies
end_enemies
