48,6
48,64
2
12,0,0,0,0,0,0,0,0,0,0,0,0,0,0,0,0,0,0,0,0,0,0,0,0,0,0,0,0,0,0,0,0,0,0,0,0,25,16,6,38,6,38,3,3,38,6,38
30,2,0,0,0,0,0,0,27,27,0,27,0,0,27,2,27,2,0,0,0,0,27,27,0,0,0,0,0,0,13,25,0,0,0,0,14,6,30,6,38,44,38,21,6,38,3,38
37,43,0,0,0,0,0,0,43,43,0,43,0,0,43,43,43,43,0,0,0,0,43,43,0,0,0,0,0,0,19,31,14,0,0,7,6,6,37,6,38,3,38,3,44,38,6,38
30,30,36,36,30,36,30,30,30,30,36,36,36,30,36,30,30,30,36,36,36,30,30,30,20,30,20,30,20,36,30,30,30,36,30,30,30,30,16,16,15,6,38,3,3,38,3,38
37,18,1,42,1,42,24,37,12,18,1,42,1,42,24,12,37,18,1,42,1,42,24,37,37,18,1,42,1,42,24,37,12,18,24,37,12,37,16,6,38,35,38,21,21,38,6,38
12,7,14,7,26,26,26,39,37,7,32,32,32,32,7,39,39,32,32,32,32,32,32,39,12,26,32,32,32,14,7,12,37,26,26,37,30,12,16,6,15,9,15,9,9,15,9,15
doors
end_doors
miscellaneous
1,28,64,1,1

1,1244,64,1,1
1,1308,64,1,19

5,1308,94,1,4,1196,64
9,1330,142,1,7

1,1372,110,1,1
1,1436,110,1,1
1,1500,110,1,1
end_miscellaneous
stair
end_stair
enemies
111,1295.f, 133.15f
112,1515.f, 133.15f
end_enemies
