24,6
48,128
0
39,12,39,0,0,0,0,37,0,0,0,0,0,0,0,0,0,17,39,22,37,12,39,16
39,30,12,0,0,0,0,34,0,0,20,0,0,0,0,0,0,17,37,39,22,37,12,16
12,37,37,2,0,0,27,40,0,0,40,2,0,0,0,0,27,42,37,28,30,30,37,16
37,39,39,43,32,0,43,37,0,11,37,43,11,11,11,11,43,32,28,39,37,39,39,16
30,36,30,36,30,30,36,30,30,36,30,36,36,30,30,30,36,36,36,30,30,30,30,16
39,12,39,12,37,1,42,37,1,42,12,1,42,12,1,42,1,42,12,37,12,39,39,16
doors
3,2,592,-40,640,31
end_doors
miscellaneous
1,32,64,1,10
1,99,96,1,10

1,548,32,1,17
1,612,96,1,10
1,676,96,1,10
end_miscellaneous
stair
1,568,96
4,632,32
2,664,32
end_stair
enemies
end_enemies
