24,6
720,160
0
16,30,22,39,12,39,46,34,30,30,30,30,36,36,30,36,30,30,36,30,36,30,1,38
16,37,39,22,39,39,46,40,37,1,42,37,12,1,42,34,37,1,42,12,1,42,20,38
16,39,39,39,22,12,46,37,12,26,14,12,37,2,7,40,39,2,27,37,26,14,37,38
16,12,39,30,30,30,46,20,37,20,7,37,12,43,6,37,39,43,43,12,26,7,39,45
16,30,39,12,39,37,46,37,12,41,37,39,39,30,37,12,39,37,37,37,37,39,39,4
16,39,30,30,10,10,5,10,10,10,10,10,10,10,10,10,10,10,10,10,10,16,16,16
doors
1,2,64,-40,96,31
end_doors
miscellaneous
1,92,128,1,1

1,156,64,1,1

1,220,144,1,1
1,284,144,1,1

9,288,128,1,7

1,348,144,1,1
1,412,144,1,1
1,476,144,1,1
1,540,144,1,15
1,604,144,1,1
1,668,144,1,8

1,732,128,1,14
end_miscellaneous
stair
2,152,64
end_stair
enemies
end_enemies
