24,6
48,64
0
16,30,22,39,12,39,46,34,30,30,30,30,36,36,30,36,30,30,36,30,36,30,1,38
16,37,39,22,39,39,46,40,37,1,42,37,12,1,42,34,37,1,42,12,1,42,20,38
16,39,39,39,22,12,46,37,12,26,14,12,37,2,7,40,39,2,27,37,26,14,37,38
16,12,39,30,30,30,46,20,37,20,7,37,12,43,6,37,39,43,43,12,26,7,39,45
16,30,39,12,39,37,46,37,12,30,30,39,39,30,37,12,39,37,37,37,37,39,39,4
16,39,30,30,10,10,5,10,10,10,10,10,10,10,10,10,10,10,10,10,10,16,16,16
doors
end_doors
miscellaneous
end_miscellaneous
stair
end_stair
enemies
end_enemies
